████████████
█          █
█ ██ █████ █
█ █      █ █
█ █      █ █
█ █      █ █
█ █      █ █
█ █      █ █
█ █    $ █ █
█ █      █ █
█ ████████ █
█          █
████████████